NO textures/s_slay.xpm
SO textures/farquaad_bed.xpm
EA textures/shrek_bed.xpm
WE textures/full_shrek.xpm
F 59,24,4
C 0,160,255

                    1111111111111111111111111 
                     10000000001100000000000011111
                      1110110000011100000000000011
   1                   10010000000000000W000000111    1       
  101           111111111011000001110000000000001    101
   1            10000000011000001110111111111111      1
                11110111111111011100000010001 
                11111111111111111101010010001
                11000000110101011100000010001               
                10000000000000001100000010001
                10000000000000001101010010001
                1100000111010101111101111000111           1
                11110111 1110101 101111010001            101
                11111111 1111111 111111111111             1